billets-doux	`[.2bI.0le.1du]
tabindex	Tab Index
omg	oe em jee
LOL	ell oe ell
AKA	ay keigh ay
Volte-face	`[.2valt.1fas]
AKK	ay keigh keigh
EARC	ee ay ar cea
mbox	em `0 box
init	`[.1In.0It]
os	oe ess
tête-à-têtes	`[.2tE.0Fx.1tEts]
Billet-doux	`[.2bI.0le.1du]
Airbnb	Air bea en bea
airbnb	Air bea en bea
airbnbs	air bea en beas
AK	ay keigh
billet-doux	`[.2bI.0le.1du]
Dvbviewer	dee vee bea viewer
SUV	ess yue vee
ODE	oe dee ee
DOS	`[.1das]
csun	cee `0 sun
Laissez-faire	`[.2lE.0se.1fer]
USAGM	yue ess aigh jee em
APA	ay pea ay
ios	igh oe ess
FAQ	eff ay kew
probraille	pro braille
Billets-doux	`[.2bI.0le.1du]
Billets-Doux	`[.2bI.0le.1du]
BILLETS-DOUX	`[.2bI.0le.1du]
IRIB	igh ar igh bea
MYSQL	my ess kew l
sndup	ess en dee up
laissez-faire	`[.2lE.0se.1fer]
nvda	en vee dee ay
Wii	`[.1wi]
cnet	seanet
Sndup	ess en dee up
KES	keigh ee ess
EV	ee vee
IMHO	igh em aitch oe
Statusbar	Status Bar
GUI	jee yue igh
IFA	igh eff ay
ibm	igh bea em
freedomscientific	Freedom Scientific
Tête-à-têtes	`[.2tE.0Fx.1tEts]
Sys	`[.1sIs]
NYC	en wie cea
WASU	doubleyou aigh ess yue
Tête-à-tête	`[.2tE.0Fx.1tEt]
wii	`[.1wi]
washpost	wash post
realspeak	real speak
apm	ay pea em
NYT	en wie tea
tête-à-tête	`[.2tE.0Fx.1tEt]
ACT	ay cea tea
pwn	`[.1pon]
nvaccess	en vee access
rsgames	ar ess games
statusbar	Status Bar
elmercat	elmer cat
SMA	ess em ay
volte-face	`[.2valt.1fas]
Volte-Face	`[.2valt.1fas]
VOLTE-FACE	`[.2valt.1fas]
CSUN	cea `0 sun
CES	cea ee ess
sys	`[.1sIs]
Xi	shee
gui	jee yue igh
Probraille	pro braille
ifa	`[.1i.0fx]
Realspeak	real speak
OLED	oe ell ee dee
Init	`[.1In.0It]
ip	igh pea
xmplay	eks em play
JPEG	jeigh `0 peg
MPEG	em `0 peg
belles-lettres	`[.2bEl.1lE.0trx]
fxbus	eff eks bus
WEIU	doubleyou ee igh yue
Belles-lettres	`[.2bEl.1lE.0trx]
Belles-Lettres	`[.2bEl.1lE.0trx]
BELLES-LETTRES	`[.2bEl.1lE.0trx]
CNET	seanet
openvpn	open vee pea en
TEFL	`[.1tE.0fxl]
afb	ay eff bea
IEC	igh ee cea
IEEE	igh tripple ee
EFF	ee eff eff
T-Mobile	tea mobil
afp	ay eff pea
Geeksfor	geeks for
ISS	igh ess ess
IOS	igh oe ess
hbo	aitch bea oe
gsuite	jee Suite
abc	ay bea cea
imdb	igh em dee bea
vmware	vee em ware
AOC	ay oe cea
FOIA	eff oe igh ay
UG	yue jee
IHS	igh aitch ess
UAC	yue ay cea
FIDE	fee day
mise-en-scène	`[.2mi.0zcn.1sEn]
Mise-en-scène	`[.2mi.0zcn.1sEn]
Mise-En-Scène	`[.2mi.0zcn.1sEn]
MISE-EN-SCÈNE	`[.2mi.0zcn.1sEn]
mise-en-scènes	`[.2mi.0zcn.1sEnz]
Mise-en-scènes	`[.2mi.0zcn.1sEnz]
Mise-En-Scènes	`[.2mi.0zcn.1sEnz]
MISE-EN-SCÈNES	`[.2mi.0zcn.1sEnz]
MISE-EN-SCENE	`[.2mi.0zcn.1sEn]
MISE-EN-SCENES	`[.2mi.0zcn.1sEnz]
USCENTCOM	yue ess sent `0 caam
espn	ee ess pea en
EBU	ee bea yue
Notebookcheck	notebook check
ANC	ay en cea
APH	ay pea aitch
rnib	ar en igh bea
Cas	cass
CRISPR	`[.1krIs.0pR]
Crispr	`[.1krIs.0pR]
OSM	oe ess em
POS	pea oe ess
bas-relief	`[.2ba.0rX.1lif]
Bas-relief	`[.2ba.0rX.1lif]
Bas-Relief	`[.2ba.0rX.1lif]
BAS-RELIEF	`[.2ba.0rX.1lif]
IRC	igh ar cea
Pianoforall	piano for all
AZT	ay zee tea
Duckduckgo	Duck duck go
TEAMTALK	team talk
AAC	ay ay ce
thestar	the star
LA	ell ay
QA	kew ay
TEFL's	`[.1tE.0fxlz]
regedit	rej edit
Regedit	rej edit
Parton	`[.1par.0?N]
Parton's	`[.1par.0?Nz]
UFS	yue eff ess
MINSK	`[.1mInsk]
idk	igh dee keigh
bloodred	blood red
Bloodred	blood red
BLOODRED	blood red
Nvda	en vee dee ay
VAR	vee ay ar
ARL	ay ar ell
ILM	igh ell em
AWS	ay doubleyou es
CIS	cea igh ess
ESA	ee ess ay
EZ	ee zee
MONTH	month
MONTHS	months
OK'd	`[.2o.1ked]
OCR'd	oe cea ard
UEB	yue ee bea
VFO	vee eff oe
vfogroup	vee eff oe group
VSI	vee ess igh
RUR	ar yue ar
FE	eff ee
textarea	text area
uk	yue keigh
MA	em ay
acb	ay cea bea
usa	yue ess ay
OIS	oe igh ess
EIS	ee igh ess
spec'd	specked
Spec'd	specked
EP	ee pea
EPS	ee pea ess
LE	ell ee
AOSP	ay oe ess pea
googlesource	google source
ppi	pea pea igh
aws	ay doubleyou ess
MAGA	em ay jee ay
IIS	igh igh ess
LGBTQIA	ell jee bea tea kew igh ay
LGBTIQA	elll jee bea tea igh kew ay
NYU	en wie yue
nyu	en wie yue
edu	ee dee yue
Suu	su
Kyi	che
uni	yuni
Uni	yuni
UNE	yue en ee
une	yue en ee
mm	em em
OFWGKTA	oe eff doubleyou jee keigh tea ay
tnauk	tea en ay yue keigh
fda	eff dee ay
IEP	igh ee pea
EUV	ee yue vee
arl	ay ar ell
Digi	dijji
umich	yue mish
CSUNATC	cea sun ay tea cea
AG	ay jee
filezilla	file zilla
winscp	win ess cea p
IAP	igh ay pea
usf	yue ess eff
USF	yue ess eff
MABB	em ay bea bea
aaas	ay ay ay ess
nti	en tea igh
Poedit	pea oe edit
poedit	pea oe edit
ATA	ay tea ay
USTA	yue ess tea ay
usta	yue ess tea ay
CC'd	cea seed
cc'd	cea seed
cc'ed	cea seed
CC'ed	cea seed
cc'ing	cea seaing
CC'ing	cea seaing
PA	pea ay
Pocketnow	pocket now
pocketnow	pocket now
NEEDTOBREATHE	need to breathe
roly-poly	`[.2ro.0li.1po.0li]
Roly-poly	`[.2ro.0li.1po.0li]
Roly-Poly	`[.2ro.0li.1po.0li]
ROLY-POLY	`[.2ro.0li.1po.0li]
roly-polies	`[.2ro.0li.1po.0liz]
Roly-polies	`[.2ro.0li.1po.0liz]
Roly-Polies	`[.2ro.0li.1po.0liz]
ROLY-POLIES	`[.2ro.0li.1po.0liz]
aol	ay oe ell
showme	show me
systemctl	system ctl
hostnamectl	hostname ctl
chmod	ch mod
chown	ch own
mariadb	maria dee bea
ufw	yue eff doubleyou
BOJ	bea oe jeigh
STORYCORPS	Story Corps
ICT	igh cea tea
IPS	igh pea ess
UBS	yue bea ess
Mentos	`[.1mEn.2tas]
readonly	reed only
Readonly	reed only
icarly	igh carly
VGA	vee jee ay
OTA	oe tea ay
Opensouls	open souls
batchcommand	batch command
nethome	net home
Nethome	net home
sysadmin	siss admin
Sysadmin	siss admin
sysadmins	siss adminz
Sysadmins	siss adminz
htaccess	ht access
getopts	get opts
Getopts	get opts
printf	print f
histfile	hist file
cater-corner	`[.1kA.0Fi.2kcr.0nR]
Cater-corner	`[.1kA.0Fi.2kcr.0nR]
Cater-Corner	`[.1kA.0Fi.2kcr.0nR]
CATER-CORNER	`[.1kA.0Fi.2kcr.0nR]
cater-cornered	`[.1kA.0Fi.2kcr.0nRd]
Cater-cornered	`[.1kA.0Fi.2kcr.0nRd]
Cater-Cornered	`[.1kA.0Fi.2kcr.0nRd]
CATER-CORNERED	`[.1kA.0Fi.2kcr.0nRd]
Jos	joss
ALM	ay ell em
palsy-walsy	`[.2pAl.0zi.1wAl.0zi]
Palsy-walsy	`[.2pAl.0zi.1wAl.0zi]
Palsy-Walsy	`[.2pAl.0zi.1wAl.0zi]
PALSY-WALSY	`[.2pAl.0zi.1wAl.0zi]
shangri-la	`[.1SAG.0grX.2la]
Shangri-la	`[.1SAG.0grX.2la]
Shangri-La	`[.1SAG.0grX.2la]
SHANGRI-LA	`[.1SAG.0grX.2la]
shangri-las	`[.1SAG.0grX.2laz]
Shangri-las	`[.1SAG.0grX.2laz]
Shangri-Las	`[.1SAG.0grX.2laz]
SHANGRI-LAS	`[.1SAG.0grX.2laz]
CE	cea ee
DXOMARK	dee eks oe mark
EFS	ee eff ess
SRAM	ess `0 ram
VAD	vee ay dee
ENT	ee en tea
CUV	cea yue vee
ICO	igh cea oe
PED	pea ee dee
AVI	ay vee igh
LED	ell ee dee
HLA	aitch ell ay
EB	ee bea
CISA	cea igh ess ay
Afp	ay eff pea
TSA	tea ess ay
TSAT	tea ess ay tea
NA	en ay
Accu	`[.1A.0kyu]
accu	`[.1A.0kyu]
ACCU	`[.1A.0kyu]
accuweather	`[.1A.0kyu.2wE.0DR]
ITU	igh tea yue
SOS	ess oe ess
YT	wie tea
io	igh oe
APU	ay pea yue
ADT	ay dee tea
nvdacon	en vee dee ay con
AM	ay em
DOT	dee oe tea
HIIT	hit
IRL	igh ar ell
ABS	ay bea ess
SES	ess ee ess
CAI	cea ay igh
UX	yue eks
UVA	yue vee aigh
dpi	dee pea igh
nowplaying	now playing
AF	ay eff
BIPAC	buypaac
AIBA	ay igh bea ay
read-only	reed only
Read-only	reed only
Read-Only	reed only
PHONEARENA	phone arena
CAGR	cea ay jee ar
UWB	yue doubleyou bea
zdnet	zee dee net
Allrecipes	all recipes
MOTORTREND	motor trend
TWE	tea doubleyou ee
IDFA	igh dee eff ay
faq	eff ay kew
PSAT	pea ess ay tea
SNES	ess en ee ess
Airbnbs	Air BN BEES
UWP	yue doubleyou pea
IGN	igh jee en
P!nk	pink
vgmstream	vee jee em stream
tsa	tea ess ay
lol	elll oe ell
Lol	elll oe ell
url	yue ar ell
IMEI	igh em ee igh
IED	igh ee dee
Pulseaudio	Pulse Audio
pulseaudio	Pulse Audio
DEA	dee ee ay
shoot-em-up	`[.1Su.0txm.2Hp]
beat-em-up	`[.1bi.0txm.2Hp]
shoot-em-ups	`[.1Su.0txm.2Hps]
beat-em-ups	`[.1bi.0txm.2Hps]
Cul-de-sac	`[.1kHl.0dx.2sAk]
cul-de-sac	`[.1kHl.0dx.2sAk]
cul-de-sacs	`[.1kHl.0dx.2sAks]
Cul-de-sacs	`[.1kHl.0dx.2sAks]
Culs-de-sac	`[.1kHlz.0dx.2sAk]
culs-de-sac	`[.1kHlz.0dx.2sAk]
Megaupload	mega `1 upload
megaupload	mega `1 upload
Freedb	Free DB
freedb	Free DB
QWERTY	`[.1kwR.0ti]
openmpt	Open MPT
MBROLA	`[.2Em.1bro.0lx]
Mbrola	`[.2Em.1bro.0lx]
Hydrogenaudio	Hydrogen Audio
ID'd	`1 igh `[did]
roledescription	role description
Yooka-Laylee	`[.2yu.0kx.1le.0li]
IBS	`1 igh BS
Qi	`[.1Ci]
Axl	`[.1Ak.0sxl]
Soniccouture	sonic `[.0kx.1Cur]
SUSE	`[.1su.0sx]
AAS	`1 Ay Ay S
8Dio	8 `0 Dio
Yu-Gi-Oh	`[.1yu.2gi.0o]
Gamestop	game stop
gamestop	game stop
USIA	yue ess igh ay
Weeknd	`[.1wi.2kEnd]
Weeknd's	`[.1wi.2kEndz]
xcruiser	eks cruiser
Xcruiser	eks cruiser
XCRUISER	eks cruiser
AGL	ay jee ell
PWA	pea doubleyou ay
LAV	ell ay vee
AEDT	ay ee dee tea
ISO	igh ess oe
ISQ	igh ess kew
UDID	yue dee igh dee
SIO	ess igh oe
Xcover	eks cover
AAPI	ay ay pea igh
EAP	ee ay pea
PHA	pea aitch ay
mani-pedi	`[.2mA.0ni.1pE.0Fi]
Mani-pedi	`[.2mA.0ni.1pE.0Fi]
MANI-PEDI	`[.2mA.0ni.1pE.0Fi]
mani-pedis	`[.2mA.0ni.1pE.0Fiz]
Mani-pedis	`[.2mA.0ni.1pE.0Fiz]
MANI-PEDIS	`[.2mA.0ni.1pE.0Fiz]
JAMA	jamma
Aix-en-Provence	`[.2eks.0an.0prx.1vans]
IBT	igh bea tea
OTOH	oe tea oe aitch
UFED	yue eff ee dee
A-list	`[.1e.2lIst]
A-lister	`[.1e.2lI.0stR]
MIUI	mee yue igh
GEI	jee ee igh
GEDI	jee ee dee igh
SFO	ess eff oe
seanbudd	sean budd
OFDMA	oe eff dee em ay
MU-MIMO	m yue mimo
VBA	vee bea ay
VMI	vee em igh
NAS	en ay ess
IFA	igh eff ay
TIA	tea igh ay
AEW	ay ee doubleyou
DOE	dee oe ee
NIHL	en igh aitch ell
SIV	ess igh vee
ASIC	ay ess igh cea
ATH	ay tea aitch
CEX	cea ee eks
UNOPS	yue en ops
UNOPS's	yue en opses
pflog	pf log
mcast	em `0 cast
URS	yue ar ess
UGRS	yue jee ar ess
UHL	yue aitch ell
timedatectl	time date ctl
aerohive	aero `0 hive
Aerohive	aero `0 hive
AEROHIVE	aero `0 hive
UAP	yue ay pea
ADATA	ay data
adata	ay data
IAPP	igh ay pea pea
CIPP	cea igh pea pea
ARDS	ay ar dee ess
Crowdsignal	Crowd signal
UEFI	yue ee eff igh
OST	oe ess tea
BIA	bea igh ay
UKVI	yue keigh vee igh
IRTVU	igh ar tea vee yue
AUC	ay yue cea
idclip	igh dee clip
Idclip	igh dee clip
IDCLIP	igh dee clip
NIJ	en igh jeigh
ACIP	ay cea igh pea
IAC	igh ay cea
DEI	dee ee igh
you-uns	yunz
You-uns	yunz
YOU-UNS	yunz
BIOS	`[.1bY.0os]	
BIOS's	`[.1bY.0o.0sXz]	
AIFF	ay igh eff eff
AIFF	ay igh eff eff
ALU	ay ell yue
ABT	ay bea tea
ACU	ay cea yue
de-extinction	`[.2di.0Xk.1stIGk.0SXn]
De-extinction	`[.2di.0Xk.1stIGk.0SXn]
De-Extinction	`[.2di.0Xk.1stIGk.0SXn]
DE-EXTINCTION	`[.2di.0Xk.1stIGk.0SXn]
VMO	vee em oe
MOPP	em oe pea pea
Mobipocket	mobi pocket
mobipocket	mobi pocket
whoo-ee	`[.2hu.1i]
Whoo-ee	`[.2hu.1i]
WHOO-EE	`[.2hu.1i]
ROFLMAO	ar oe eff ell em ay oe
NUC	nuck
IIHS	igh igh aitch ess
Je	`[.1ZU]
IME	igh em ee
EQT	ee kew tea
jack-o'-lantern	`[.1JAk.0x.2lAn.0tRn]
Jack-o'-lantern	`[.1JAk.0x.2lAn.0tRn]
Jack-o'-Lantern	`[.1JAk.0x.2lAn.0tRn]
jack-o-lantern	`[.1JAk.0x.2lAn.0tRn]
Jack-o-Lantern	`[.1JAk.0x.2lAn.0tRn]
Jack-O'-Lantern	`[.1JAk.0x.2lAn.0tRn]
jack-o'-lanterns	`[.1JAk.0x.2lAn.0tRnz]
Jack-o'-lanterns	`[.1JAk.0x.2lAn.0tRnz]
Jack-o'-Lanterns	`[.1JAk.0x.2lAn.0tRnz]
jack-o-lanterns	`[.1JAk.0x.2lAn.0tRnz]
Jack-o-Lanterns	`[.1JAk.0x.2lAn.0tRnz]
Jack-O'-Lanterns	`[.1JAk.0x.2lAn.0tRnz]
will-o'-the-wisp	`[.2wIl.0x.0DX.1wIsp]
Will-o'-the-wisp	`[.2wIl.0x.0DX.1wIsp]
Will-O'-The-Wisp	`[.2wIl.0x.0DX.1wIsp]
Will-o'-the-Wisp	`[.2wIl.0x.0DX.1wIsp]
WILL-O'-THE-WISP	`[.2wIl.0x.0DX.1wIsp]
will-o'-the-wisps	`[.2wIl.0x.0DX.1wIsps]
Will-o'-the-wisps	`[.2wIl.0x.0DX.1wIsps]
Will-O'-The-Wisps	`[.2wIl.0x.0DX.1wIsps]
Will-o'-the-Wisps	`[.2wIl.0x.0DX.1wIsps]
WILL-O'-THE-WISPS	`[.2wIl.0x.0DX.1wIsps]
JACK-O'-LANTERN	`[.1JAk.0x.2lAn.0tRn]
JACK-O-LANTERN	`[.1JAk.0x.2lAn.0tRn]
JACK-O-LANTERNS	`[.1JAk.0x.2lAn.0tRnz]
JACK-O'-LANTERNS	`[.1JAk.0x.2lAn.0tRnz]
immersivecontrolpanel	immersive control panel	
OB-GYN	oe bea jee wie en
ob-gyn	oe bea jee wie en
Ob-gyn	oe bea jee wie en
OBGYN	oe bea jee wie en
ATIA	ay tea igh ay
Nreal	en real
Xclipse	eks clipse
ALS	ay ell ess
EEG	ee ee jee
openssh	open ssh
fstab	fs tab
EFI	ee eff igh
initrd	`[.1In.0It] rd
initramfs	`[.1In.0It] ram fs
vmlinux	vm linux
bzip	bea `0 zip
gzip	jee `0 zip
debuginfo	debug info
Debuginfo	debug info
uname	yue `0 name
nmap	en `0 map
sysfs	sis fs
devpts	dev pts
securityfs	security fs
debugfs	debug fs
autofs	auto fs
mqueue	em `0 kew
hugepages	huge `0 pages
mini-mes	`[.1mI.0ni.2miz]
Mini-mes	`[.1mI.0ni.2miz]
Mini-Mes	`[.1mI.0ni.2miz]
MINI-MES	`[.1mI.0ni.2miz]
BEV	bea ee vee
HEV	aitch ee vee
PHEV	pea aitch ee vee
LVIV	`[.0lx.1viv]
RINO	`[.1rY.0no]
UAD	yue ay dee
ATVI	ay tea vee igh
ENC	ee en cea
Readiris	reed iris
Nanonets	nano `0 nets
nanonets	nano `0 nets
vivosmart	veevo `0 smart
vívosmart	veevo `0 smart
Vivosmart	veevo `0 smart
ELT	ee ell tea
TESL	`[.1tE.0sxl]
TESL's	`[.1tE.0sxlz]
USTRANSCOM	yue ess trans `0 kaam
ECT	ee cea tea
AOB	ay oe bea
CUS	cea yue ess
UAV	yue ay vee
VTOL	`[.1vi.2tcl]
HOV	aitch oe vee
ASIS	`[.1e.0sXs]
ESOL	eesol
GNI	jee en igh
tuk-tuk	`[.1tUk.2tUk]
Tuk-tuk	`[.1tUk.2tUk]
Tuk-Tuk	`[.1tUk.2tUk]
TUK-TUK	`[.1tUk.2tUk]
DOI	dee oe igh
SEO	ess ee oe
SMO	ess em oe
UCAS	`[.1yu.2kAs]
UTI	yue tea igh
e-zine	ee `0 zeen
E-zine	ee `0 zeen
E-Zine	ee `0 zeen
E-ZINE	ee `0 zeen
e-zines	ee `0 zeenz
E-zines	ee `0 zeenz
E-Zines	ee `0 zeenz
E-ZINES	ee `0 zeenz
nvdaremote	 en vee dee ay remote
Nvdaremote	 en vee dee ay remote
IDO	igh dee oe
ADU	ay dee yue
IOD	igh oe dee
VOD	vee oe dee
VDU	vee dee yue
USSTRATCOM	yue ess strat `0 kaam
USP	yue ess pea
IB	igh bea
Pwn	`[.1pon]
ILY	igh ell wie
Vaid-Menon	vad mennon
VAID-MENON	vad mennon
ASM	ay ess em
EFE	ee eff ee
Rege-Jean	`[.1re.0ge] `1 `[.1Zcn]
Rege-Jean's	`[.1re.0ge] `1 `[.1Zcnz]
Regé-Jean	`[.1re.0ge] `1 `[.1Zcn]
Regé-Jean's	`[.1re.0ge] `1 `[.1Zcnz]
edu-vacation	`[.2E.0JX.2ve.1ke.0SXn]
edu-vacations	`[.2E.0JX.2ve.1ke.0SXnz]
Edu-vacation	`[.2E.0JX.2ve.1ke.0SXn]
Edu-vacations	`[.2E.0JX.2ve.1ke.0SXnz]
Edu-Vacation	`[.2E.0JX.2ve.1ke.0SXn]
Edu-Vacations	`[.2E.0JX.2ve.1ke.0SXnz]
IDE	igh dee ee
ACH	ay cea aitch
CIAI	cea igh ay igh
HODL	`[.1ho.0dxl]
fullmetal	full `1 metal
Fullmetal	full `1 metal
FULLMETAL	full `1 metal
playerunknown	player `1 unknown
Playerunknown	player `1 unknown
PLAYERUNKNOWN	player `1 unknown
LISZT	`[.1lIst]
LISZT's	`[.1lIsts]
AMI	ay em igh
SKU	`[.1skyu]
SWI	ess doubleyou igh
SRI	ess ar igh
GNU	`[.0gx.1nu]
libopenmpt	lib open mpt
Escooter	ee scooter
escooter	ee scooter
Escooters	ee scooters
escooters	ee scooters
NGINX	`[.1En.0JX.2nEks]
IAF	igh ay eff
Mar-a-Lago	`[.2mar.0x.1la.0go]
Mar-a-Lago's	`[.2mar.0x.1la.0goz]
Mar-A-Lago	`[.2mar.0x.1la.0go]
Mar-A-Lago's	`[.2mar.0x.1la.0goz]
meme'd	`[.1mimd]
Meme'd	`[.1mimd]
MEME'D	`[.1mimd]
redcedar	red `1 cedar
Redcedar	red `1 cedar
REDCEDAR	red `1 cedar
SUBPACS	`[.1sHb.2pAks]
HUD	aitch yue dee
ZDNET	zee dee net
Te'o	`[.1te.0o]
Te'o's	`[.1te.0oz]
ELN	ee ell en
Flightradar	flight `1 radar
flightradar	flight `1 radar
OUP	oe yue pea
EVA	ee vee ay
xyz	eks wie zee
XYZ	eks wie zee
Citizenfour	citizen `1 four
CITIZENFOUR	citizen `1 four
GNU's	`[.0gx.1nuz]
WYSO	doubleyou wie ess oe
FMOD	`[.1Ef.2mad]
FMOD's	`[.1Ef.2madz]
cwtch	`[.1kUC]
Cwtch	`[.1kUC]
CWTCH	`[.1kUC]
pwns	`[.1ponz]
Pwns	`[.1ponz]
libxmp	lib eks em p
MIC	em igh cea
EDI	ee dee igh
EDIB	ee dee igh bea
NATIFS	naytifs
teampixel	team pixel
Teampixel	team pixel
Q-Tip	`[.1kyu.2tIp]
Q-Tips	`[.1kyu.2tIps]
Q-Tip's	`[.1kyu.2tIps]
TUMBLR	`[.1tHm.0blR]
TUMBLR's	`[.1tHm.0blRz]
Yooka-Laylee's	`[.2yu.0kx.1le.0liz]
yooka-laylee	`[.2yu.0kx.1le.0li]
OANN	oe ay en en
OAN	oe ay en
BADBADNOTGOOD	bad bad not good
badbadnotgood	bad bad not good
daysofstatic	days of static
65DAYSOFSTATIC	65 days of static
USO	yue ess oe
USSO	yue ess ess oe
XCIENT	`[.1Ek.0si.0Xnt]
XCIENT's	`[.1Ek.0si.0Xnts]
AT	ay tea
UAS	yue ay ess
ovpntray	oe vee pea en tray
ovpn	oe vee pea en
Esc	escape
FERC	eff ee ar cea
CSAM	`[.1si.2sAm]
CSAM's	`[.1si.2sAmz]
Vypr	viper
MCAS	`[.1Em.2kAs]
Iplayer	igh Player
IPLAYER	igh Player
Champs-Elysees	`[.2Scn.0ze.2li.1ze]
Champs-Élysées	`[.2Scn.0ze.2li.1ze]
Champs-Elysées	`[.2Scn.0ze.2li.1ze]
Champs-Élysées's	`[.2Scn.0ze.0li.1zez]
Elysées's	`[.2e.0li.1zez]
CRE	sea ar ee
naiveproxy	naive proxy
Naiveproxy	naive proxy
GUID	jee yue igh dee
UUID	yue yue igh dee
WUWM	doubleyou yue doubleyou em
XRAI	`[.1Eks.0re]
XRAI's	`[.1Eks.0rez]
TWU	tea doubleyou yue
Dpiano	dee piano
McDede	`[.0mXk.1did]
McDede's	`[.0mXk.1didz]
NXIVM	`[.1nEk.0si.0xm]
NXIVM's	`[.1nEk.0si.0xmz]
XAML	`[.1zA.0mxl]
XAML's	`[.1zA.0mxlz]
AST	ay ess tea
delattr	del `[.1At.0rx]
getattr	get `[.1At.0rx]
getattribute	get attribute
setattr	set `[.1At.0rx]
iocage	igh oe cage
webui	web yue igh
AMSAT	`[.1Am.2sAt]
YMO	wie em oe
GEHA	jee ee aitch ay
randchal	`[.1rAnd.2CAl]
randunofficial	rand unofficial
onlinemsg	online em ess gee
offlinemsg	offline em ess gee
lbplayer	ell bea player
emailset	`[.1i.2mel.2sEt]
emailget	`[.1i.2mel.2gEt]
deleteme	delete me
muteclear	`[.1myut.2klir]
getpaid	`[.1gEt.2ped]
creditsend	`[.1krE.0FXt.2sEnd]
bugreport	`[.1bHg.0rX.2pcrt]
likesclear	`[.1lYksh.2klir]
mapinfo	`[.1mAp.2In.0fo]
chalrestart	`[.1CAl.0ri.2start]
changemap	`[.1CenJ.2mAp]
getdata	`[.1gEt.2de.0Fx]
newmap	`[.1nu.2mAp]
rawmap	`[.1rc.2mAp]
rawdata	`[.1rc.2de.0Fx]
renmap	`[.1rEn.2mAp]
delmap	`[.1dEl.2mAp]
undomap	`[.0Hn.1du.2mAp]
redomap	`[.0ri.1du.2mAp]
requestmap	`[.0rX.1kwEst.2mAp]
reqmap	`[.1rEk.2mAp]
Bluemercury	blue mercury
fyp	eff wie pea
FYP	eff wie pea
aka	ay keigh ay
SEEG	ess ee ee jee
journalctl	journal ctl
initctl	init ctl
thespinoff	the spinoff
qcsalon	qc salon
apk	ay pee kay
dgdebug	dee gee debug
utf	yew tea eff
groupadd	group `0 add
stackoverflow	stack overflow
stackexchange	`[.1stAk.0Xks.2CenJ]
NVIDIA	`[.0Xn.1vI.0Fi.0x]
NVIDIA's	`[.0Xn.1vI.0Fi.0xz]
brailleroledescription	braille role description
PSU	pea ess yue
WUFT	doubleyou yue eff tea
RHYTHM	`[.1rI.0Dxm]
RHYTHM's	`[.1rI.0Dxmz]
RHYTHM'S	`[.1rI.0Dxmz]
RZA	`[.1rI.0zx]
RZA's	`[.1rI.0zxz]
XROS	`[.1krcs]
eliquid	ee liquid
Eliquid	ee liquid
ELIQUID	ee liquid
eliquids	ee liquids
Eliquids	ee liquids
ELIQUIDS	ee liquids
litrpg	lit ar pee gee
chatgpt	chat gee pee tea
Chatgpt	chat gee pee tea
adsl	ay dee ess ell
Louis-Dreyfus	`[.1lu.0i] `[.1drY.0fxs]
libarchive	lib archive
Libarchive	lib archive
libarchive's	lib archives
Libarchive's	lib archives
urls	yue ar ells
gamelit	game lit
Gamelit	game lit
GAMELIT	game lit
pronouncekiwi	pronounce kiwi
WEKU	doubleyou ee kay yue
DLA	dee ell ay
KYUK	keigh wy yue keigh
KYAC	keigh yue ay sea
KIYU	keigh eye wy yue
KLOP	keigh ell oh pee
KHUU	keigh aiche yue yue
KIGG	keigh aye jee jee
KIAN	keigh aye ay enn
KOTZ	keigh oh tea zee
KNIB	keigh en eye bea
KUUK	keigh yue yue keigh
KORI	keigh oh ar eye
KIEA	keigh eye ee ay
KUSC	keigh yue ess cea
KUSF	keigh yue ess eff
KQED	keigh kew ee dee
WHO	doubleyou aitch oe
WERS	doubleyou ee ar ess
WETA	doubleyou ee tea aigh
WESS	doubleyou ee ess ess
WABE	doubleyou aigh bea ee
WUKY	doubleyou yue keigh wie
WAMU	doubleyou ay em yue
WUNC	doubleyou yue en cea
VOA	vee oe ay
KUOW	keigh yue oe doubleyou
KUPS	keigh yue pea ess
KUAT	keigh yue ay tea
KUAZ	keigh yue ay zee
KUSA	keigh yue ess ay
WUSF	doubleyou yue ess eff
KUER	keigh yue ee ar
KWIT	keigh doubleyou igh tea
KICI	keigh igh cea igh
WREM	doubleyou ar ee em
WOUB	doubleyou oe yue bea
WUAL	doubleyou yue ay ell
KNAU	keigh en ay yue
KNAG	keigh en ay jee
KUYI	keigh yue wy igh
KNAD	keigh en ay dee
KAWP	keigh ay yue pee
KNAQ	keigh en ay cue
KNAA	keigh en ay ay
KAWC	keigh ay doubleyou sea
KOFA	keigh oh eff aigh
KUAF	keigh yue eigh eff
KASU	keigh eigh ess yue
KUAR	keigh yue eigh ar
KHEC	keigh aiche ee sea
KESC	keigh ee ess sea
KUOR	keigh yue oh ar
KAZU	keigh ay zee yue
KUOP	keigh yue oh pee
KNYR	keigh en wy ar
KAJX	keigh ay jay ex
KUVO	keigh yue vee oh
KENC	keigh ee en sea
KUNC	keigh yue en sea
KUTE	keigh yue tea ee
KICO	keigh eye sea oh
KOTO	keigh oh tea oh
WESU	doubleyou ee ess yue
WECS	doubleyou ee sea ess
WUWF	doubleyou yue doubleyou eff
WUGA	doubleyou yue jee ay
WRAS	doubleyou ar ay ess
WUWG	doubleyou yue doubleyou jee
KIPH	keigh aye pee aiche
KANO	keigh ay en oh
KIPO	keigh eye pee oh
KAHU	keigh ay aiche yue
KISU	keigh eye ess yue
WEPS	doubleyou ee pee ess
WIUM	doubleyou eye yue em
WUSI	doubleyou yue ess eye
WIPA	doubleyou eye pee ay
WUIS	doubleyou yue eye ess
WILL	doubleyou eye ell ell
WILL-FM	doubleyou igh ell ell eff em
WIUW	doubleyou eye yue doubleyou
WISU	doubleyou eye ess yue
WOI	doubleyou oh eye
KUNI	keigh yue en eye
KIWR	keigh eye doubleyou ar
KOJI	keigh oh jay eye
KANQ	keigh ay en cue
KANH	keigh ay en aiche
KANZ	keigh ay en zee
KANU	keigh ay en yue
WEKH	doubleyou ee keigh aiche
WUOL	doubleyou yue oh ell
WEAA	doubleyou ee ay ay
WYPO	doubleyou wy pee oh
WESM	doubleyou ee ess em
WUMB	doubleyou yue em bea
WAMQ	doubleyou ay em cue
WAIC	doubleyou ay eye sea
WUOM	doubleyou yue oh em
WAUS	doubleyou ay yue ess
WIAA	doubleyou eye ay ay
WIAB	doubleyou eye ay b
WICA	doubleyou eye sea ay
WEMU	doubleyou ee em yue
WIRN	doubleyou eye ar en
KAXE	keigh ay ex ee
KNOW-FM	keigh en oh doubleyou ef em
KNOW	keigh en oh doubleyou
WIRR	doubleyou eye ar ar
WURC	doubleyou yue ar sea
KAUD	keigh ay yue dee
KUHM	keigh yue aiche em
KYPH	keigh wy pee aiche
KIOS-FM	keigh eye oh ess eff em
KIOS	keigh igh oh ess
WEVO	doubleyou ee vee oh
WEVQ	doubleyou ee vee cue
WEVS	doubleyou ee vee ess
KUNM	keigh yue en em
KENU	keigh ee en yue
KENE	keigh ee en ee
KRAR	keigh ar ay ar
KUUT	keigh yue yue tea
KANM	keigh ay en em
KIDS	keigh eye dee ess
KOAZ	keigh oh ay zee
KENG	keigh ee en jee
KENM	keigh ee en em
WEXT	doubleyou ee ex tea
WEOS	doubleyou ee oh es
WITH	doubleyou eye tea aiche
WOLN	doubleyou oh ell en
WRUN	doubleyou ar yue en
WRUR	doubleyou ar yue ar
WANZ	doubleyou ay en zee
WAER	doubleyou ay ee ar
WANC	doubleyou ay en sea
WUNY	doubleyou yue en wy
WUND-FM	doubleyou yue en dee eff em
WUND	doubleyou yue en dee
WURI	doubleyou yue ar igh
WYQS	doubleyou wy cue es
KEYA	keigh ee wy ay
KUND	keigh yue en dee
WOUC-FM	doubleyou oh yue sea eff em
WOUH-FM	doubleyou oh yue aich eff em
WOUH	doubleyou oh yue aiche
WOSU-FM	doubleyou oh ess yue eff em
WOSU	doubleyou oh ess yue
WOSE	doubleyou oh ess ee
WOSA	doubleyou oh ess eigh
WOUL	doubleyou oh yue ell
WOSV	doubleyou oh ess vee
WOSP	doubleyou oh ess pee
WYSU	doubleyou wy ess yue
WOUZ-FM	doubleyou oh yue zee eff em
WOUZ	doubleyou oh yue zee
KOUA	keigh oh yue eigh
KOCU	keigh oh sea yue
KQOU	keigh cue oh yue
KROU	keigh ar oh yue
KOSU	keigh oh ess yue
KWOU	keigh doubleyou oh yue
KOAC	keigh oh eigh sea
KOAC-FM	keigh oh eigh sea eff em
KOAB	keigh oh eigh bea
KOAB-FM	keigh oh eigh bea eff em
KOGL	keigh oh jee ell
KAGI	keigh eigh jee igh
KOAP	keigh oh eigh pee
KOOZ	keigh oh oh zee
WESA	doubleyou ee ess eigh
WYEP	doubleyou wy ee pee
WYEP-FM	doubleyou wy ee pee ef em
KAUR	keigh eigh yue ar
WETS-FM	doubleyou ee tea ess ef em
WETS	doubleyou ee tea es
WUOT	doubleyou yue oh tea
KACU	keigh eigh sea yue
KUT	keigh yue tea
KAMU	keigh eigh em yue
KAMU-FM	keigh eigh em yue ef em
KEOS	keigh ee oh ess
KEDT	keigh ee dee tea
KEDT-FM	keigh ee dee tea ef em
KERA	keigh ee ar eigh
KUQU	keigh yue cue yue
KUEU	keigh yue ee yue
KUSU	keigh yue ess yue
KUSU-FM	keigh yue ess yue ef em
KUST	keigh yue ess tea
KUXU	keigh yue ex yue
KUHU	keigh yue aiche yue
KUOU	keigh yue oh yue
KUSK	keigh yue ess keigh
WRIQ	doubleyou ar igh cue
WIQR	doubleyou igh cue ar
WISE-FM	doubleyou igh ess ee ef em
KQOW	keigh cue oh doubleyou
KOMQ	keigh oh em cue
KYVT	keigh wy vee tea
WHAA	doubleyou aiche eigh eigh
WUWS	doubleyou yue doubleyou ess
WHAD	doubleyou aiche eigh dee
WUEC	doubleyou yue ee sea
WHID	doubleyou aiche igh dee
WERN	doubleyou ee ar en
WHA	doubleyou aiche eigh
WYMS	doubleyou wy em es
KUWS	keigh yue doubleyou ess
KUWA	keigh yue doubleyou eigh
KUWC	keigh yue doubleyou sea
KUWE	keigh yue doubleyou ee
KUWW	keigh yue doubleyou doubleyou
KUWG	keigh yue doubleyou jee
KUWJ	keigh you doubleyou jay
KUWK	keigh yue doubleyou keigh
KUWL	keigh yue doubleyou ell
KUWR	keigh yue doubleyou ar
KUWY	keigh yue doubleyou wy
KUWV	keigh yue doubleyou vee
KUWN	keigh yue doubleyou en
KUWX	keigh yue doubleyou ex
KUWP	keigh yue doubleyou pee
KUWI	keigh yue doubleyou igh
KUWZ	keigh yue doubleyou zee
KAIW	keigh eigh igh doubleyou
KUWD	keigh yue doubleyou dee
KUWT	keigh yue doubleyou tea
KEUW	keigh ee yue doubleyou
abdl	ay bea dee ell
ynab	`[.1wY.2nAb]
YNAB	`[.1wY.2nAb]
OMB	oh em bee
ibmeci	igh bee em ee sea igh
IBMECI	igh bee em ee sea igh
ibmtts	igh bee em tea tea ess
ffmpeg	eff eff `[.1Em.0pEg]
Ffmpeg	eff eff `[.1Em.0pEg]
FFmpeg	eff eff `[.1Em.0pEg]
Fmpeg	eff `[.1Em.0pEg]
openssl	open SSL
Openssl	Open SSL
JSON	`[.1Je.2san]
agri-food	`[.1Ag.0rX.2fud]
Agri-food	`[.1Ag.0rX.2fud]
Agri-Food	`[.1Ag.0rX.2fud]
DAZN	`[.0dx.1zon]
DAZN's	`[.0dx.1zonz]
brltty	bee ar ell tea tea wie
Livingetc	living etcetera
UNGA	yue en jee ay
ATACMS	`[.0x.1tA.0kxmz]
ATACMS's	`[.0x.1tA.0kxm.0zXz]
MCAT	`[.1Em.2kAt]
MCAT's	`[.1Em.2kAts]
exe	ee eks ee
puteketeke	`0 pu tehki tehki
Puteketeke	`0 pu tehki tehki
puteketekes	`0 pu tehki techies
Puteketekes	`0 pu tehki techies
USFS	yue ess eff ess
uptodown	`[.2Hp.0tx.1dWn]
Uptodown	`[.2Hp.0tx.1dWn]
NIAMH	neev
lmao	ell em ay oe
lmfao	ell em eff aigh oe
rofl	ar oe eff ell
Lmao	ell em ay oe
Lmfao	ell em eff aigh oe
Rofl	ar oe eff ell
ai	aigh igh
api	aigh pee igh
XREAL	`[.1Eks.2ril]
XREAL's	`[.1Eks.2rilz]
Ios	igh oe ess
recorder's	`[.0rX.1kcr.0FRz]
Recorder's	`[.0rX.1kcr.0FRz]
AQI	aigh kew igh
CAQI	cea aigh kew igh
EAQI	ee aigh kew igh
XGIMI	`[.1Eks.2JI.0mi]
XGIMI's	`[.1Eks.2JI.0miz]
BYD	bee wie dee
XTREAM	`[.0Xk.1strim]
ODI	oe dee igh
ROS	ar oe ess
gris-gris	`[.1gri.0gri]
Gris-gris	`[.1gri.0gri]
Gris-Gris	`[.1gri.0gri]
GRIS-GRIS	`[.1gri.0gri]
Louisville's	`[.1lu.0i.2vIlz]
LOUISVILLE'S	`[.1lu.0i.2vIlz]
Idk	igh dee keigh
AZW	aigh zee doubleyou
azw	aigh zee doubleyou
neverending	never ending
Neverending	never ending
NEVERENDING	never ending
AESP	ay ee ess pee
CZE	cea zee ee
CRI	cea ar igh
Ai	ay igh
stfu	ess tea eff yue
Stfu	ess tea eff yue
sbyw	ess bea wie doubleyou
spyw	ess pea wie doubleyou
errormessage	error message
Transedit	trans `1 edit
id	igh dee
Id	igh dee
